Radiohead	Artist
released	Irrelevant
King of Limbs	Album
back	No Tag
in	No Tag
February,	Irrelevant
but	No Tag
for some reason	Irrelevant
they	Irrelevant
waited	Irrelevant
until	Irrelevant
last month	Irrelevant
to	No Tag
actually	Irrelevant
promote	Irrelevant
the	No Tag
thing.	Irrelevant
10	No Tag
'How To Dissapear Completely'	Song
Share	Format
Absolutely	Irrelevant
everybody	Irrelevant
loves	Irrelevant
it	Irrelevant
now,	Irrelevant
but	No Tag
when	No Tag
Kid A	Album
came out	Irrelevant
back	No Tag
in	No Tag
2000,	Irrelevant
some	No Tag
people	Irrelevant
weren't	Irrelevant
blown away.	Irrelevant
7	No Tag
'Let Down'	Song
Share	Format
OK Computer	Album
hit	Irrelevant
a lot of	Irrelevant
people	Irrelevant
by surprise	Irrelevant
when	No Tag
it	Irrelevant
hit shelves	Irrelevant
in	No Tag
the	No Tag
summer	Irrelevant
of	No Tag
1977	Irrelevant
A	No Tag
cultural	Irrelevant
force	Irrelevant
that	No Tag
transcends	Irrelevant
generations.	Irrelevant
Enter	Irrelevant
your	Irrelevant
Email	Format
Subscribe	Format
Swifties	Irrelevant
Rejoice:	Irrelevant
Here's	No Tag
Where	No Tag
to	No Tag
Find	Irrelevant
Taylor Swift	Artist
'Eras'	Irrelevant
Tour	Irrelevant
Tickets	Irrelevant
Online	Irrelevant
If	No Tag
you	Irrelevant
had	Irrelevant
to	No Tag
play	Irrelevant
somebody	Irrelevant
one	Irrelevant
Radiohead	Artist
song	Irrelevant
to	No Tag
convince	Irrelevant
them	Irrelevant
of	No Tag
the	No Tag
band's	Irrelevant
brilliance,	Irrelevant
it	Irrelevant
should	Irrelevant
probably	Irrelevant
be	Irrelevant
"Paranoid Android."	Song
112 hour	Irrelevant
playlist	Irrelevant
of the	No Tag
most	No Tag
recognizable	Irrelevant
songs	Irrelevant
of all time!	No Tag
Great	No Tag
for	No Tag
road trips	Irrelevant
;)	No Tag
https://open.spotify.com/user/caaakeeey/playlist/6QAKnenuZoowNqxRzZbeRg	Format
Just	No Tag
as	No Tag
I	No Tag
shut off	Irrelevant
my	No Tag
motor	Irrelevant
and	No Tag
lights,	Irrelevant
the	No Tag
playlist	Irrelevant
randomly	Irrelevant
rotates....	Irrelevant
Floyd's	Artist
Wish You Were Here.	Song
So	No Tag
there	No Tag
I am	No Tag
all	No Tag
alone	Irrelevant
in the	No Tag
pitch black	Irrelevant
watching	No Tag
meteors	Irrelevant
burn	Irrelevant
into	No Tag
our	No Tag
atmosphere	Irrelevant
and	No Tag
Gilmour	Artist
just	No Tag
rolling	Irrelevant
out of	No Tag
my	No Tag
speakers	Irrelevant
singing	Irrelevant
about	No Tag
the	No Tag
loss	Irrelevant
of	No Tag
his	No Tag
old	Irrelevant
friend	Irrelevant
Syd.	Irrelevant
I had	No Tag
something	Irrelevant
like	No Tag
this...	Irrelevant
about	No Tag
80	Irrelevant
different	Irrelevant
songs	Irrelevant
but	Irrelevant
all	No Tag
my	No Tag
favorites.	Irrelevant
Now That's What I Call Music! Volume 112	Album
Out of	No Tag
curiosity,	Irrelevant
did you	No Tag
put	Irrelevant
Ice Ice Baby	Song
and	No Tag
Under Pressure	Song
back to back	No Tag
in the	No Tag
playlist	Irrelevant
intentionally?	Irrelevant
Inb4	No Tag
all	No Tag
songs	Irrelevant
change	Irrelevant
to	No Tag
Rick Astley	Artist
in	No Tag
2 days	Irrelevant
Well	No Tag
now	No Tag
I	No Tag
have to	No Tag
go	Irrelevant
bust out	Irrelevant
the	No Tag
Pink Floyd	Artist
vinyl	Irrelevant
and	No Tag
slip	Irrelevant
away	Irrelevant
for	No Tag
a while	No Tag
Maybe	No Tag
break it up	No Tag
with	No Tag
one	Irrelevant
play	Irrelevant
of	No Tag
Tom Jones'	Artist
"It's Not Unusual"	Song
Grammys	Irrelevant
2022:	Irrelevant
Nominees,	Irrelevant
Performers,	Irrelevant
Winners	Irrelevant
&	No Tag
More	Irrelevant
News	Irrelevant
|	No Tag
Pitchfork	Irrelevant
Skip	Irrelevant
to	No Tag
content	Irrelevant
See	Irrelevant
the	No Tag
Full	Irrelevant
List	Irrelevant
Here	Irrelevant
Who	No Tag
won	Irrelevant
Best New Artist,	Irrelevant
Album of the Year,	Irrelevant
and	No Tag
Song of the Year?	Irrelevant	
Watch	Irrelevant
Lady Gaga	Artist
Perform	Irrelevant
"Love for Sale"	Song
and	No Tag
"Do I Love You"	Song
at	No Tag
Grammys	Irrelevant
Kanye West,	Artist
the Weeknd,	Artist
and	No Tag
Lil Baby	Artist
Win	Irrelevant
Best	Irrelevant
Melodic	Irrelevant
Rap	Irrelevant
Performance	Irrelevant
at	No Tag
the	No Tag
2022	Irrelevant
Grammys	Irrelevant
by:	No Tag
Matthew Ismael	Irrelevant
Watch	Irrelevant
Lil Nas X	Artist
and	No Tag
Jack Harlow	Artist
Perform	Irrelevant
"Dead Right Now,"	Song
"Montero,"	Song
and	No Tag
"Industry Baby"	Song
at	No Tag
the	No Tag
2022	Irrelevant
Grammys	Irrelevant
Olivia Rodrigo	Artist
SOUR	Album
Four	Irrelevant
months	Irrelevant
after	Irrelevant
"drivers license,"	Song
pop's	Irrelevant
newest	Irrelevant
star	Irrelevant
offers	Irrelevant
a	No Tag
nimble	Irrelevant
and	No Tag
lightly	Irrelevant
chaotic	Irrelevant
collection	Irrelevant
of	No Tag
breakup	Irrelevant
tunes	Irrelevant
filled	Irrelevant
with	No Tag
melancholy	Irrelevant
and	No Tag
mischief.	Irrelevant
Billie Eilish	Artist
Happier Than Ever	Song
On	No Tag
her	Irrelevant
second	Irrelevant
album,	Irrelevant
Billie Eilish	Artist
sings	Irrelevant
with	No Tag
unsparing	Irrelevant
honesty	Irrelevant
about	No Tag
her	Irrelevant
rapid	Irrelevant
ascent	Irrelevant
to	Irrelevant
stardom	Irrelevant
and	No Tag
all	No Tag
its	Irrelevant
accompanying	Irrelevant
horrors.	Irrelevant